XEXXXXXXXXXXXXXXXXXXXXXXXXXXXXXXXXXXXXXXXXXXXXXXXXXXXXXXXXXXXXX
XOOOXOOOOOXOXOOOXOXOOOOOOOOOOOOOXOOOOOXOOOOOOOOOOOXOOOOOXOOOOOX
XOXXXOXOXOXOXOXOXOXOXXXXXXXOXOXXXOXOXOXXXXXXXXXXXOXOXOXXXOXXXOX
XOOOOOXOXOXOOOXOXOOOXOXOOOXOXOXOOOXOXOXOOOOOOOOOOOXOXOXOOOOOXOX
XOXXXXXXXOXXXOXOXOXXXOXOXOXOXXXOXXXXXOXOXXXXXXXXXOXOXXXOXXXOXOX
XOXOOOXOOOXOOOXOXOOOOOXOXOOOXOOOXOOOXOXOOOXOOOXOOOOOXOOOXOXOXOX
XOXOXOXOXXXOXXXOXXXXXOXOXXXXXOXXXOXOXOXXXOXOXOXOXXXXXOXOXOXOXXX
XOXOXOXOOOXOOOXOXOOOXOXOXOOOOOXOOOXOXOOOXOXOXOXOOOOOXOXOXOOOOOX
XOXOXOXXXOXXXXXOXOXXXOXOXOXOXXXOXXXOXXXOXOXOXOXXXXXOXOXOXXXXXOX
XOOOXOXOXOOOOOOOXOOOXOXOXOXOOOXOOOXOOOXOXOOOXOOOXOXOOOXOXOOOXOX
XXXXXOXOXXXXXXXXXXXOXOXOXXXXXOXXXOXXXOXOXXXXXXXOXOXXXXXOXOXXXOX
XOOOXOXOOOXOXOOOOOXOOOXOXOOOOOXOOOOOXOXOOOOOOOXOXOOOXOOOXOOOOOX
XOXOXOXXXOXOXOXOXOXXXXXOXOXXXXXOXXXOXOXOXXXXXOXOXXXOXOXXXXXXXOX
XOXOXOOOOOXOXOXOXOOOOOXOOOXOOOXOXOOOXOXOOOXOOOXOOOXOOOXOOOXOOOX
XOXOXXXOXXXOXOXOXXXXXOXXXXXOXOXOXOXXXOXXXOXOXXXXXOXXXXXOXOXOXXX
XOXOXOXOOOOOXOXOOOXOOOXOOOOOXOXOXOOOXOOOOOXOOOXOOOOOOOOOXOXOOOX
XOXOXOXOXXXXXOXXXOXOXXXOXXXXXXXOXXXXXXXXXXXXXOXOXXXXXXXXXOXXXXX
XOXOXOXOOOOOXOXOXOXOXOOOXOOOOOOOXOOOXOOOOOOOXOXOOOOOOOXOXOOOOOX
XOXOXOXXXXXOXOXOXOXOXOXOXOXXXXXXXOXOXOXOXXXOXOXXXXXXXOXOXXXXXOX
XOXOXOXOOOOOOOXOOOXOOOXOXOXOOOXOOOXOOOXOXOOOXOOOOOOOXOXOXOOOOOX
XOXOXOXOXXXXXXXXXXXOXXXOXOXOXOXOXXXXXXXXXOXXXXXXXXXOXOXOXOXXXXX
XOXOXOOOXOOOXOOOXOOOXOOOOOXOXOXOXOOOXOOOXOOOOOXOOOXOOOXOOOXOOOX
XXXOXXXXXOXXXOXOXOXXXOXXXXXOXOXOXOXXXOXOXXXXXOXOXOXXXXXOXXXOXOX
XOOOOOOOXOXOOOXOXOOOXOOOXOOOXOOOXOXOOOXOXOOOXOOOXOOOOOOOXOOOXOX
XOXXXXXOXOXOXXXOXXXOXXXXXOXXXXXXXOXOXXXOXOXXXXXXXXXXXOXOXXXXXOX
XOXOOOXOXOOOXOOOXOXOOOOOXOXOOOXOOOXOOOXOOOXOOOOOXOOOXOXOXOOOOOX
XOXXXOXOXOXXXOXXXOXXXXXOXOXOXOXOXXXXXXXXXOXOXXXXXOXOXOXXXOXXXOX
XOOOXOOOXOXOOOXOOOOOXOOOXOXOXOOOXOOOOOXOOOXOOOXOOOXOXOXOOOXOOOX
XOXOXXXXXOXOXXXXXOXOXXXXXOXOXXXXXOXXXOXOXXXXXOXOXXXOXOXOXXXXXOX
XOXOOOOOOOXOOOOOXOXOOOXOOOXOOOOOXOOOXOOOXOOOOOXOXOOOXOXOXOOOXOX
XOXXXXXXXXXXXXXOXOXOXOXXXOXXXOXOXXXOXXXXXOXXXXXOXOXXXOXOXOXOXXX
XOOOXOOOOOOOOOOOXOXOXOOOXOOOXOXOOOOOXOOOOOOOOOOOXOXOXOOOOOXOOOX
XOXOXXXXXXXXXXXXXOXXXXXOXXXOXXXXXXXOXXXXXXXXXXXXXOXOXXXXXXXXXOX
XOXOXOOOXOOOXOOOXOOOOOXOOOXOOOOOOOOOOOXOOOXOOOOOXOXOOOOOOOOOOOX
XOXOXOXOXOXOXOXOXXXXXOXXXOXXXXXXXXXXXOXOXOXXXOXOXOXOXXXXXXXXXOX
XOXOOOXOOOXOXOXOOOXOOOXOOOOOOOOOOOXOXOXOXOXOOOXOOOXOXOOOXOOOOOX
XOXXXXXXXXXOXOXXXOXOXXXOXXXXXOXXXOXOXOXXXOXOXXXOXXXXXOXOXOXXXXX
XOOOOOXOOOOOXOXOOOXOOOXOOOXOOOXOOOOOXOOOOOXOXOOOXOXOOOXOXOOOOOX
XXXXXOXOXXXXXOXOXXXXXXXOXXXOXXXOXXXXXXXXXOXOXOXXXOXOXXXOXOXXXXX
XOOOOOXOOOOOXOXOOOOOOOXOXOOOOOXOXOOOOOOOXOXOXOOOXOOOXOOOXOXOOOX
XOXXXXXXXOXOXOXXXXXXXOXXXOXXXOXOXXXXXXXOXOXOXXXXXOXXXOXXXOXOXOX
XOXOOOOOXOXOXOOOOOXOOOXOOOXOOOXOOOOOOOOOXOXOOOOOOOXOXOXOOOXOXOX
XXXOXOXOXXXOXXXXXOXOXXXOXXXXXXXOXXXXXXXXXOXXXXXOXOXOXOXOXOXOXOX
XOOOXOXOOOOOXOOOXOXOOOXOOOOOXOOOXOOOXOOOXOOOXOOOXOXOOOXOXOOOXOX
XOXOXXXXXXXXXOXOXOXXXOXXXXXOXOXXXOXOXOXOXXXOXXXXXXXXXOXXXXXXXXX
XOXOOOXOOOOOOOXOOOXOOOXOOOXOXOXOOOXOOOXOXOXOOOXOOOOOXOOOOOOOOOX
XOXXXOXOXXXXXXXXXXXOXXXOXOXOXOXXXOXOXXXOXOXXXOXOXOXOXXXXXXXXXOX
XOXOXOOOXOOOOOXOOOXOOOOOXOOOXOOOOOXOOOXOOOXOOOXOXOXOOOOOXOXOOOX
XOXOXXXXXOXXXOXOXOXXXOXXXXXXXXXXXXXXXXXOXXXOXOXOXOXXXXXOXOXOXXX
XOXOOOOOXOOOXOXOXOOOXOOOXOOOOOXOOOOOXOOOXOOOXOOOXOXOOOXOOOXOOOX
XOXXXXXOXXXOXOXOXXXOXXXOXOXXXOXXXXXOXOXXXOXXXXXXXXXOXXXOXXXXXOX
XOOOXOXOXOOOXOXOOOXOOOXOXOOOXOOOOOXOOOXOOOOOOOXOOOXOOOXOXOOOXOX
XOXOXOXOXOXXXOXXXOXXXXXOXXXOXXXOXOXXXXXOXXXXXXXOXOXXXOXOXOXOXOX
XOXOOOXOOOXOXOOOXOOOOOXOOOXOXOOOXOXOOOOOOOXOOOOOXOXOOOXOOOXOOOX
XXXXXOXXXXXOXOXOXXXXXOXOXXXOXOXXXXXOXXXXXXXOXOXXXOXOXOXXXXXXXXX
XOOOOOOOOOOOXOXOOOXOOOXOXOOOXOXOOOOOXOOOOOOOXOOOXOOOXOXOXOOOOOX
XOXXXXXXXXXXXOXXXOXOXXXOXOXXXOXOXXXXXOXXXXXXXXXXXXXXXOXOXOXXXOX
XOOOOOXOOOXOOOOOXOOOXOOOOOXOOOXOOOOOOOXOOOOOOOOOXOOOOOXOOOXOOOX
XXXXXOXOXOXXXOXOXXXOXOXXXXXXXXXXXXXOXXXXXOXXXXXOXOXOXXXXXXXOXOX
XOOOXOOOXOXOOOXOXOXOXOXOOOOOOOXOOOXOOOOOXOXOOOXOOOXOXOOOOOXOXOX
XOXXXXXXXOXOXXXOXOXOXOXOXXXOXOXOXOXXXXXOXOXXXOXOXXXXXOXXXOXOXOX
XOOOOOOOOOOOXOOOXOOOXOOOXOOOXOOOXOOOOOOOXOOOOOXOOOOOOOXOOOOOXOX
XXXXXXXXXXXXXXXXXXXXXXXXXXXXXXXXXXXXXXXXXXXXXXXXXXXXXXXXXXXXXSX
