Solved Maze:
XPXXX
XPXXX
XPXXX
XPOOO
XXXXX

XEXXX
XXXXX
XXXXX
PPOOO
SXXXX