2
101 101
XXXXXXXXXXXXXXXXXXXXXXXXXXXXXXXXXXXXXXXXXXXXXXXXXXXXXXXXXXXXXXXXXXXXXXXEXXXXXXXXXXXXXXXXXXXXXXXXXXXXX
XOXOOOOOOOOOOOXOOOOOOOOOOOOOOOXOOOOOOOXOOOOOOOOOXOOOXOOOXOOOOOOOXOOOOOXOOOXOOOOOXOOOXOOOOOXOOOXOOOOOX
XOXOXXXXXXXXXOXXXXXXXXXXXXXXXOXOXXXXXOXXXXXXXXXOXXXOXOXOXOXXXXXOXOXXXOXOXOXXXXXOXOXOXOXXXXXOXOXOXXXOX
XOOOOOOOXOOOOOXOOOOOOOOOOOOOOOOOXOOOXOXOOOOOOOXOOOOOOOXOOOOOXOOOXOOOXOOOXOOOOOOOXOXOXOXOOOOOXOXOOOXOX
XXXXXXXOXOXXXXXOXXXXXXXXXXXXXXXOXXXOXOXOXOXXXOXXXXXXXXXXXXXXXOXXXXXOXXXXXXXXXOXXXOXOXOXOXXXOXOXOXOXOX
XOOOOOXOXOOOXOXOOOOOOOOOOOXOOOOOXOOOOOXOXOOOXOOOXOOOOOOOXOOOXOOOXOOOXOXOOOOOXOXOXOXOXOXOOOXOXOXOXOXOX
XOXXXXXOXXXOXOXOXXXOXXXXXOXOXXXXXOXXXXXOXXXOXXXXXOXXXOXXXOXOXXXOXOXXXOXOXXXOXOXOXOXOXOXXXOXXXOXOXOXXX
XOXOOOXOOOXOOOXOOOXOOOXOOOXOXOOOXOOOXOOOXOXOOOOOOOOOXOOOOOXOXOOOXOXOOOXOOOXOXOXOXOXOOOXOXOOOXOOOXOOOX
XOXOXOXXXOXXXOXXXXXXXOXOXXXOXOXXXXXOXXXOXOXXXXXOXXXXXXXXXXXOXOXOXOXXXOXXXOXXXOXOXOXXXOXOXXXOXXXXXXXOX
XOOOXOOOXOOOXOOOXOOOXOXOXOOOOOXOOOXOOOXOXOOOOOOOXOXOOOOOOOOOOOXOXOXOOOXOOOOOOOXOOOOOXOOOOOXOXOOOOOXOX
XXXXXXXOXOXXXXXOXOXOXOXXXOXXXXXOXXXXXOXOXXXXXXXXXOXOXXXXXXXXXXXXXOXOXOXOXXXXXXXXXXXOXXXXXOXOXOXXXOXOX
XOOOXOOOXOXOOOXOOOXOOOXOOOXOOOXOOOOOXOXOOOOOOOOOXOXOXOOOOOXOOOOOOOXOXOXOOOOOOOXOOOXOOOXOOOXOXOOOXOOOX
XOXOXOXOXOXOXOXXXXXXXXXOXXXOXOXXXOXOXOXXXXXXXXXOXOXOXOXXXXXOXXXXXOXOXXXXXXXXXOXOXXXOXOXXXXXOXOXOXXXXX
XOXOXOXOXOOOXOXOOOXOOOOOXOOOXOOOXOXOXOOOXOOOXOXOOOXOXOOOOOXOOOOOXOOOXOOOOOXOOOXOOOXOXOOOOOOOXOXOOOOOX
XOXOXOXXXXXXXOXOXOXOXXXXXOXXXXXOXOXOXXXOXOXOXOXOXXXOXXXXXOXXXXXOXXXXXOXXXOXOXXXXXOXXXXXXXXXXXXXOXXXOX
XOXOOOXOOOXOOOXOXOOOXOOOOOXOOOXOOOXOOOXOOOXOOOXOXOOOXOOOOOXOOOXOOOOOOOOOXOXOOOOOOOXOOOOOOOOOOOXOOOXOX
XOXXXOXOXOXOXXXOXXXXXOXXXXXOXOXXXXXOXXXXXXXOXXXOXXXOXOXXXOXOXOXXXXXXXXXXXOXXXXXXXXXOXOXXXOXOXOXXXOXOX
XOXOXOOOXOOOXOOOXOOOXOXOOOOOXOXOOOXOXOOOOOXOOOOOXOOOXOOOXOOOXOOOXOOOXOOOXOXOOOXOOOOOXOXOXOXOXOXOOOXOX
XOXOXXXXXXXXXOXXXOXXXOXOXXXXXOXXXOXOXOXOXOXXXXXXXOXXXOXXXXXXXXXOXOXOXOXOXOXOXOXOXXXOXOXOXOXXXOXOXXXXX
XOXOOOOOOOOOXOOOXOOOXOXOXOOOOOOOXOXOXOXOXOOOXOOOXOXOOOXOOOOOXOOOOOXOOOXOXOXOXOXOOOXOXOOOXOOOXOXOOOOOX
XOXOXXXXXXXOXXXOXXXOXOXOXOXOXXXOXOXOXOXXXXXOXOXOXOXXXXXOXXXOXXXXXXXOXXXOXOXOXOXXXOXOXXXXXXXOXOXXXXXOX
XOXOXOXOOOOOXOOOOOXOXOOOXOXOOOXOXOOOXOOOXOOOXOXOOOXOOOXOXOOOOOXOOOXOXOXOOOOOXOOOXOXOXOOOOOOOXOXOOOXOX
XOXOXOXOXXXXXOXOXOXOXXXXXXXOXXXOXXXXXXXOXOXXXOXXXXXOXOXOXOXXXOXOXOXOXOXXXXXXXXXOXOXXXOXXXXXXXOXOXOXOX
XOXOXOOOXOOOOOXOXOOOXOOOOOXOXOOOXOOOOOOOXOOOXOXOOOOOXOOOXOOOXOXOXOXOOOXOOOXOOOXOXOOOXOOOXOOOXOOOXOXOX
XOXOXOXXXOXXXXXOXXXOXXXOXOXXXOXXXXXXXXXOXXXOXOXOXXXOXXXXXXXOXOXOXOXXXOXOXOXOXOXOXXXOXOXOXOXOXXXXXOXOX
XOXOXOXOXOOOOOXOXOXOOOOOXOOOXOXOOOOOOOXOOOXOXOXOXOXOOOXOOOXOXOXOXOOOXOOOXOXOXOOOOOOOXOXOOOXOXOOOXOOOX
XOXOXOXOXXXXXOXOXOXOXXXOXXXOXOXOXXXOXOXXXXXOXOXOXOXXXOXOXOXXXOXOXXXXXXXXXOXXXXXXXXXXXOXXXXXOXOXXXXXOX
XOXOXOOOOOOOXOXOOOXOOOXOXOXOXOOOXOOOXOXOOOOOXOXOOOXOOOXOXOOOXOXOOOXOOOOOOOXOOOXOOOOOXOOOOOXOXOOOOOXOX
XOXXXOXXXXXOXOXXXXXXXXXOXOXOXXXXXOXXXXXOXXXXXOXXXOXXXXXOXXXOXOXXXOXOXXXXXXXOXOXXXXXOXXXXXXXOXXXOXXXOX
XOXOOOOOXOXOXOXOOOOOOOXOXOOOXOOOOOXOOOOOXOOOXOOOXOXOOOOOXOOOXOXOOOXOXOOOXOOOXOOOXOOOXOOOXOOOXOOOOOXOX
XOXOXXXOXOXOXOXOXXXXXOXOXXXXXOXXXXXXXOXXXOXOXXXOXOXOXXXXXOXXXOXOXOXOXXXOXOXXXXXOXOXXXOXXXOXXXXXXXOXOX
XOOOXOXOXOOOXOXOOOXOOOXOXOOOOOXOOOOOOOXOOOXOXOOOXOXOOOXOOOXOXOOOXOXOOOOOXOOOOOXOOOXOOOOOOOOOOOXOOOXOX
XXXXXOXOXOXXXOXXXOXOXXXOXOXXXXXXXXXOXXXOXXXOXOXXXOXXXOXOXXXOXXXXXXXXXOXXXXXXXOXXXXXOXXXXXXXXXOXOXXXOX
XOOOXOOOXOXOOOXOOOXOOOXOOOXOOOXOOOXOXOOOXOXOOOXOOOOOOOXOOOXOOOOOXOOOXOOOOOXOOOXOXOOOXOOOOOXOOOXOOOOOX
XOXOXXXXXOXOXXXOXXXXXXXOXXXOXOXOXOXOXOXXXOXXXXXOXXXXXXXXXOXXXOXXXOXOXXXXXOXOXXXOXOXXXXXXXOXOXXXXXXXXX
XOXOXOXOOOXOXOOOXOOOOOOOXOOOXOXOXOOOXOXOOOOOOOOOXOXOOOOOXOXOOOOOOOXOOOXOXOXOXOOOXOOOOOOOXOXOXOOOOOOOX
XOXOXOXOXXXOXOXXXOXXXXXXXOXOXOXOXXXOXOXXXXXXXXXXXOXOXXXOXOXOXXXXXXXXXOXOXOXOXOXOXOXXXXXOXOXOXOXXXOXXX
XOXOOOXOOOXOXOOOXOOOXOOOOOXOXOXOXOXOOOXOOOOOOOOOOOXOOOXOOOXOOOXOXOOOOOOOXOOOXOXOXOOOXOOOXOXOXOOOXOOOX
XOXXXXXXXOXOXXXOXXXOXOXXXXXXXOXOXOXXXXXOXOXXXOXXXXXXXOXXXXXXXOXOXOXXXXXXXOXXXOXXXXXOXOXXXOXXXOXOXOXOX
XOXOOOOOXOXOXOOOXOOOXOXOOOOOOOXOOOOOOOOOXOXOXOXOOOOOXOOOOOOOOOXOOOXOXOOOXOOOXOOOOOXOXOOOOOOOXOXOXOXOX
XOXOXXXOXOXXXOXXXXXOXOXXXXXXXXXXXXXXXXXXXOXOXOXOXXXOXXXXXXXXXXXXXOXOXOXOXXXXXXXXXOXOXXXXXXXOXOXXXOXOX
XOOOOOXOOOOOXOXOOOXOOOOOOOOOOOOOXOOOOOOOXOOOXOXOXOXOXOOOOOXOOOOOOOXOXOXOOOOOOOXOOOXOXOOOOOXOXOXOOOXOX
XXXXXOXXXXXOXOXOXOXXXXXOXXXXXXXOXOXXXXXXXOXOXOXOXOXOXOXXXOXOXXXOXXXOXOXXXXXXXOXOXXXOXXXXXOXOXXXOXXXOX
XOOOOOXOOOOOXOXOXOOOOOXOXOOOOOOOXOOOXOOOOOXOXOXOOOXOOOXOXOXOXOOOXOOOOOXOOOOOXOXOXOOOXOOOXOOOXOOOXOOOX
XOXXXXXXXXXOXOXOXXXXXOXXXOXXXXXXXOXOXOXXXXXOXXXXXXXOXXXOXOXOXXXXXOXXXXXOXXXOXOXOXOXXXOXOXXXOXOXXXXXOX
XOOOXOXOOOOOXOOOOOOOXOOOOOOOXOOOXOXOXOXOOOXOXOOOOOOOXOOOXOXOOOXOOOXOOOOOXOOOXOOOXOOOXOXOOOXOXOOOOOXOX
XXXOXOXOXXXXXXXXXXXOXXXXXXXOXOXOXXXOXOXOXXXOXOXXXXXXXXXOXOXXXOXOXXXXXXXOXOXXXXXXXXXOXXXXXOXOXXXXXOXOX
XOOOXOOOOOOOOOOOOOXOOOXOOOOOXOXOOOXOXOXOOOOOXOOOOOXOOOOOXOOOOOOOXOOOOOXOXOOOOOOOOOXOOOOOXOOOXOOOOOXOX
XOXOXXXXXXXXXXXXXXXXXOXXXXXXXOXXXOXOXOXXXXXOXXXXXOXOXOXXXXXXXXXXXOXXXOXXXOXXXXXXXOXXXOXOXXXXXOXXXXXOX
XOXOOOOOOOXOOOOOOOOOOOXOOOOOXOXOOOOOXOXOOOXOXOXOOOXOXOOOOOOOXOOOOOXOXOOOXOXOOOOOOOOOXOXOOOOOXOOOXOXOX
XXXXXXXXXOXXXXXOXXXXXXXOXXXOXOXOXXXXXOXOXOXOXOXOXXXXXXXXXXXOXOXXXXXOXXXOXXXOXXXXXXXXXOXXXXXOXXXOXOXOX
XOOOOOOOXOXOOOXOOOOOOOOOXOOOXOXOXOOOOOXOXOXOXOXOOOOOOOOOOOXOOOXOOOOOOOXOXOOOOOOOXOOOXOOOXOOOXOOOXOOOX
XOXXXOXOXOXOXOXXXXXXXXXXXOXXXOXXXOXXXXXOXOXOXOXXXOXXXOXXXOXXXOXXXXXOXXXOXOXXXXXXXOXOXOXXXOXXXOXXXOXXX
XOOOXOXOXOOOXOOOOOOOOOXOOOXOOOXOOOXOOOXOXOOOOOOOOOXOOOXOOOXOOOXOOOOOXOOOXOOOOOOOOOXOOOXOOOXOOOOOXOOOX
XXXOXXXOXXXXXXXXXXXXXOXOXXXOXOXOXXXOXOXOXXXXXXXXXXXXXXXXXXXOXXXOXXXXXOXXXXXXXOXXXXXXXXXOXXXOXXXXXXXOX
XOOOXOOOXOOOOOOOOOOOXOXOOOXOXOOOXOOOXOXOXOOOOOXOXOOOXOOOOOXOOOXOXOOOOOXOOOXOOOXOOOXOOOXOOOXOXOOOOOOOX
XOXXXOXOXOXXXXXXXXXOXXXXXOXXXXXXXOXXXOXOXOXXXOXOXOXOXOXXXOXXXOXOXOXXXXXOXOXOXOXXXOXOXOXXXOXOXXXXXXXXX
XOXOOOXOXOOOXOOOOOXOXOOOXOOOXOOOXOOOXOOOXOOOXOOOOOXOXOXOOOXOXOOOXOXOOOOOXOOOXOOOOOXOXOOOXOXOXOOOOOOOX
XOXOXXXOXXXOXOXXXOXOXOXOXXXOXOXXXOXXXXXXXXXXXXXXXOXXXOXOXXXOXOXXXOXOXXXXXXXXXXXXXXXOXXXOXOXOXOXXXOXOX
XOXOOOXOOOXOXOXOXOOOXOXOOOOOXOOOOOXOOOOOXOOOOOXOOOOOOOXOOOXOOOXOOOXOXOOOOOOOOOXOOOOOXOXOOOXOOOXOOOXOX
XOXXXOXXXXXOXOXOXOXXXOXXXXXXXOXXXXXOXXXOXOXOXOXXXXXXXXXXXOXXXOXOXXXXXOXXXXXXXOXOXXXXXOXOXXXXXXXOXXXOX
XOOOXOOOOOOOXOOOXOOOOOOOXOOOOOXOOOXOOOXOXOXOXOXOOOXOOOXOOOOOXOXOOOOOOOXOOOOOXOOOXOOOXOXOOOOOOOXOOOXOX
XXXOXXXXXXXXXXXXXXXXXXXOXOXOXXXOXOXXXOXOXOXOXOXOXOXOXOXXXXXOXXXXXXXOXOXXXXXOXXXXXOXOXOXXXXXXXOXXXXXOX
XOOOXOOOOOXOOOOOXOOOOOXOXOXOXOXOXOXOOOXOOOXOXOXOXOOOXOXOOOXOOOXOXOOOXOOOXOXOOOOOXOXOXOOOXOOOXOOOOOXOX
XOXXXOXOXOXXXOXOXXXXXOXOXXXOXOXOXOXOXXXXXXXOXOXOXXXXXOXOXXXXXOXOXOXXXXXOXOXOXXXXXOXOXXXOXXXOXXXOXOXOX
XOXOOOXOXOOOOOXOOOXOXOXOOOXOOOOOXOOOXOOOOOOOXOOOXOOOOOXOOOOOXOXOOOOOXOOOOOOOXOOOOOXOOOOOXOOOOOXOXOOOX
XOXOXXXOXXXXXXXOXOXOXOXXXOXXXXXXXXXXXOXXXXXXXXXXXOXXXXXOXXXOXOXXXOXXXOXXXXXXXOXXXXXXXXXXXOXXXOXOXXXXX
XOXOXOOOXOOOOOXOXOOOXOXOOOXOOOXOOOOOOOOOOOXOOOOOXOOOOOXOXOOOXOOOXOXOOOXOOOXOOOXOOOOOOOOOOOXOOOXOOOOOX
XOXXXOXXXOXXXOXOXXXOXOXOXXXOXOXOXXXXXXXXXOXXXOXXXXXXXOXXXOXOXXXOXXXOXXXXXOXOXXXOXXXXXXXXXXXXXXXXXXXOX
XOOOXOOOXOOOXOXOOOXOOOXOOOXOXOOOOOOOXOOOXOOOXOOOOOOOXOOOXOXOOOXOXOOOXOOOOOXOOOXOOOOOOOXOOOOOOOXOOOXOX
XOXOXXXOXXXOXXXOXXXXXXXXXOXXXXXXXXXXXOXXXXXOXXXXXOXXXOXOXOXXXXXOXOXOXOXXXXXXXOXXXXXXXOXOXOXXXOXOXOXOX
XOXOOOOOXOOOOOXOOOOOXOOOOOXOOOXOOOOOOOOOOOXOXOOOOOXOOOXOXOOOXOOOXOXOXOXOOOXOXOXOOOXOOOXOXOOOXOOOXOOOX
XXXXXXXXXOXXXOXXXXXOXOXOXOXOXOXXXOXXXXXXXOXOXOXXXXXOXXXXXOXOXOXXXOXOXOXOXOXOXOXOXOXOXOXOXXXOXXXXXXXXX
XOOOOOOOOOOOXOXOOOXOXOXOXOXOXOOOOOXOOOXOXOOOXOXOOOOOXOOOOOXOXOOOOOXOXOXOXOXOOOXOXOXOXOXOXOOOXOOOOOOOX
XOXXXXXXXXXXXOXOXOXOXXXOXXXOXXXXXXXXXOXOXXXXXOXXXXXOXOXOXXXXXOXXXXXXXOXOXOXOXXXOXOXOXXXOXOXXXXXOXOXXX
XOXOOOOOOOXOOOOOXOXOOOXOXOOOXOOOOOOOOOXOOOOOOOXOOOXOOOXOXOOOXOXOOOOOOOXOXOXOOOXOXOXOXOOOXOXOOOXOXOOOX
XOXOXXXXXOXOXXXXXOXXXOXOXOXXXOXXXOXXXXXOXXXXXXXOXOXXXXXXXOXOXOXXXXXOXXXXXOXXXOXXXOXOXOXXXOXXXOXXXXXOX
XOXOOOXOXOXOXOOOXOOOOOXOXOXOOOOOXOOOOOOOXOOOOOOOXOOOOOXOOOXOXOXOOOOOXOOOOOOOOOXOOOOOXOOOXOOOOOOOXOOOX
XOXXXOXOXOXOXXXOXXXXXXXOXOXOXXXOXXXXXXXXXOXOXXXXXXXXXOXOXXXOXOXOXOXXXOXXXXXXXXXOXXXOXXXOXXXXXXXOXOXXX
XOOOXOOOXOXOOOOOXOOOOOXOXOOOXOOOXOOOOOOOXOXOXOOOXOOOXOXOXOXOOOXOXOXOOOXOOOOOOOXOOOXOXOXOOOOOXOOOXOOOX
XXXOXXXOXXXOXXXOXXXXXOXOXXXXXXXXXOXXXXXOXOXOXOXOXOXOXOXOXOXXXXXOXOXXXOXOXXXXXOXXXXXOXOXXXXXOXOXOXXXOX
XOXOXOXOOOXOOOXOXOOOXOXOOOOOOOOOOOXOOOXOXOXOXOXOOOXOXOXOOOOOOOOOXOOOOOXOOOOOXOXOOOXOXOOOOOOOXOXOOOXOX
XOXOXOXXXOXXXOXOXOXOXOXXXXXXXXXXXXXOXOXOXOXOXOXXXXXOXOXXXXXOXXXXXXXXXXXXXXXOXOXOXOXOXOXXXXXXXOXXXOXOX
XOXOOOXOOOXOXOXOOOXOOOOOOOOOOOXOXOOOXOOOXOXOXOOOXOOOXOOOXOXOOOOOOOXOXOOOXOOOXOOOXOXOOOXOOOOOXOOOXOOOX
XOXOXOXOXXXOXOXXXXXXXXXXXXXXXOXOXOXXXXXOXXXOXXXOXOXXXXXOXOXXXXXXXOXOXOXOXXXOXXXOXOXXXXXXXOXXXXXOXXXXX
XOOOXOXOOOXOOOXOOOOOXOOOXOOOXOOOXOOOOOXOXOOOXOXOXOOOOOXOXOXOOOXOOOXOXOXOOOXOOOXOXOXOXOOOXOXOOOXOXOOOX
XXXXXOXXXOXXXXXOXXXOXOXXXOXOXOXOXXXXXOXXXOXXXOXOXXXXXOXOXOXOXOXXXOXOXOXXXOXXXOXOXOXOXOXOXOXOXOXOXXXOX
XOOOXOOOXOOOXOOOOOXOXOOOXOXOOOXOXOOOXOOOXOXOOOXOOOOOXOOOXOOOXOOOOOXOOOOOXOOOOOXOXOXOOOXOXOXOXOOOXOOOX
XOXOXXXOXXXOXOXXXOXOXXXOXOXXXXXOXOXOXXXOXOXOXOXXXXXOXXXXXOXXXXXXXXXXXXXOXXXXXXXOXOXOXXXOXOXOXXXXXOXOX
XOXOOOXOXOXOOOXOOOXOOOXOXOOOOOXOXOXOXOOOXOXOXOOOXOOOXOOOOOXOOOOOOOOOOOXOOOXOOOXOXOXOOOXOOOOOXOOOOOXOX
XOXXXOXOXOXXXXXOXXXOXOXOXOXXXXXOXOXXXOXXXOXOXXXOXOXXXOXXXXXXXXXXXXXXXOXXXOXOXOXXXOXOXXXXXXXXXXXXXOXOX
XOOOXOXOXOXOOOXOOOXOXOOOXOXOOOOOXOOOXOXOOOXOXOOOXOXOOOXOOOOOOOXOOOOOOOXOOOXOXOXOOOXOXOOOOOXOOOOOXOXOX
XXXOXOXOXOXOXOXXXOXXXXXOXXXOXXXXXXXOXOXOXXXOXXXXXOXOXXXOXOXXXOXOXXXXXOXXXXXOXOXOXXXOXOXXXOXXXOXOXOXXX
XOOOXOXOOOXOXOXOOOXOOOXOOOOOXOOOXOOOXOOOXOOOXOOOOOXOOOXOXOXOOOXOOOXOXOOOOOOOXOOOXOXOOOXOXOOOOOXOXOOOX
XOXOXOXXXOXOXOXOXXXOXXXXXXXXXXXOXOXXXXXOXOXOXOXXXXXXXOXOXOXOXXXXXOXOXXXOXXXXXXXXXOXXXXXOXXXXXXXOXXXOX
XOXOXOXOXOOOXOXOOOXOOOOOOOOOOOOOXOOOXOOOXOXOXOXOOOXOOOXOXOXOOOOOOOXOOOXOXOOOXOOOOOOOXOOOOOOOOOXOOOXOX
XOXOXOXOXXXXXOXXXOXXXXXOXXXOXXXXXXXOXOXXXXXOXOXOXOXOXXXOXOXXXXXOXXXOXOXOXOXXXOXXXOXOXXXXXOXXXXXOXOXOX
XOXOXOXOOOOOXOXOOOXOOOXOOOXOOOOOOOOOXOOOOOXOXOXOXOXOOOXOXOOOOOXOXOOOXOXOXOOOOOXOXOXOOOOOOOXOOOXOXOXOX
XOXOXXXOXOXOXOXOXXXOXOXXXXXXXOXXXOXXXOXXXOXOXOXOXOXOXOXXXXXXXXXOXOXXXXXOXXXOXXXOXOXXXXXXXXXOXOXOXOXOX
XOXOOOOOXOXOOOXOOOOOXOOOOOOOOOXOOOXOOOOOXOOOXOOOXOOOXOOOOOOOOOOOXOOOOOOOOOXOOOOOXOOOOOOOOOOOXOOOXOOOX
XXXXXXXSXXXXXXXXXXXXXXXXXXXXXXXXXXXXXXXXXXXXXXXXXXXXXXXXXXXXXXXXXXXXXXXXXXXXXXXXXXXXXXXXXXXXXXXXXXXXX
