Solved Maze:
XXXXXXXXXXXXXXXXXXXXXXXXXXXXXXXXXXXXXXXXXXXXXXXXXXXXXXXXXXXXXXXXXXXXXXXEXXXXXXXXXXXXXXXXXXXXXXXXXXXXX
XOXOOOOOOOOOOOXOOOOOOOOOOOOOOOXOOOOOOOXOOOOOOOOOXOOOXOOOXOOOOOOOXPPPPPXPOOXOOOOOXOOOXOOOOOXOOOXOOOOOX
XOXOXXXXXXXXXOXXXXXXXXXXXXXXXOXOXXXXXOXXXXXXXXXOXXXOXOXOXOXXXXXOXPXXXPXPXOXXXXXOXOXOXOXXXXXOXOXOXXXOX
XOOOOOOOXOOOOOXOOOOOOOOOOOOOOOOOXOOOXOXOOOOOOOXOOOOOOOXOOOOOXOOOXPPPXPPPXOOOOOOOXOXOXOXOOOOOXOXOOOXOX
XXXXXXXOXOXXXXXOXXXXXXXXXXXXXXXOXXXOXOXOXOXXXOXXXXXXXXXXXXXXXOXXXXXPXXXXXXXXXOXXXOXOXOXOXXXOXOXOXOXOX
XOOOOOXOXOOOXOXOOOOOOOOOOOXOOOOOXOOOOOXOXOOOXOOOXOOOOOOOXOOOXOOOXPPPXOXOOOOOXOXOXOXOXOXOOOXOXOXOXOXOX
XOXXXXXOXXXOXOXOXXXOXXXXXOXOXXXXXOXXXXXOXXXOXXXXXOXXXOXXXOXOXXXOXPXXXOXOXXXOXOXOXOXOXOXXXOXXXOXOXOXXX
XOXOOOXOOOXOOOXOOOXOOOXOOOXOXOOOXOOOXOOOXOXOOOOOOOOOXOOOOOXOXOOOXPXOOOXOOOXOXOXOXOXOOOXOXOOOXOOOXOOOX
XOXOXOXXXOXXXOXXXXXXXOXOXXXOXOXXXXXOXXXOXOXXXXXOXXXXXXXXXXXOXOXOXPXXXOXXXOXXXOXOXOXXXOXOXXXOXXXXXXXOX
XOOOXOOOXOOOXOOOXOOOXOXOXOOOOOXOOOXOOOXOXOOOOOOOXOXOOOOOOOOOOOXOXPXOOOXOOOOOOOXOOOOOXOOOOOXOXOOOOOXOX
XXXXXXXOXOXXXXXOXOXOXOXXXOXXXXXOXXXXXOXOXXXXXXXXXOXOXXXXXXXXXXXXXPXOXOXOXXXXXXXXXXXOXXXXXOXOXOXXXOXOX
XOOOXOOOXOXOOOXOOOXOOOXOOOXOOOXOOOOOXOXOOOOOOOOOXOXOXOOOOOXPPPPPPPXOXOXOOOOOOOXOOOXOOOXOOOXOXOOOXOOOX
XOXOXOXOXOXOXOXXXXXXXXXOXXXOXOXXXOXOXOXXXXXXXXXOXOXOXOXXXXXPXXXXXOXOXXXXXXXXXOXOXXXOXOXXXXXOXOXOXXXXX
XOXOXOXOXOOOXOXOOOXOOOOOXOOOXOOOXOXOXOOOXOOOXOXOOOXOXOOOOOXPPPPPXOOOXPPPPPXOOOXOOOXOXOOOOOOOXOXOOOOOX
XOXOXOXXXXXXXOXOXOXOXXXXXOXXXXXOXOXOXXXOXOXOXOXOXXXOXXXXXOXXXXXPXXXXXPXXXPXOXXXXXOXXXXXXXXXXXXXOXXXOX
XOXOOOXOOOXOOOXOXOOOXOOOOOXOOOXOOOXOOOXOOOXOOOXOXOOOXOOOOOXOOOXPPPPPPPOOXPXOOOOOOOXPPPPPPPOOOOXOOOXOX
XOXXXOXOXOXOXXXOXXXXXOXXXXXOXOXXXXXOXXXXXXXOXXXOXXXOXOXXXOXOXOXXXXXXXXXXXPXXXXXXXXXPXOXXXPXOXOXXXOXOX
XOXOXOOOXOOOXOOOXOOOXOXOOOOOXOXOOOXOXOOOOOXOOOOOXOOOXOOOXOOOXOOOXOOOXOOOXPXPPPXPPPPPXOXOXPXOXOXOOOXOX
XOXOXXXXXXXXXOXXXOXXXOXOXXXXXOXXXOXOXOXOXOXXXXXXXOXXXOXXXXXXXXXOXOXOXOXOXPXPXPXPXXXOXOXOXPXXXOXOXXXXX
XOXOOOOOOOOOXOOOXOOOXOXOXOOOOOOOXOXOXOXOXOOOXOOOXOXOOOXOOOOOXOOOOOXOOOXOXPXPXPXPPPXOXOOOXPPPXOXOOOOOX
XOXOXXXXXXXOXXXOXXXOXOXOXOXOXXXOXOXOXOXXXXXOXOXOXOXXXXXOXXXOXXXXXXXOXXXOXPXPXPXXXPXOXXXXXXXPXOXXXXXOX
XOXOXOXOOOOOXOOOOOXOXOOOXOXOOOXOXOOOXOOOXOOOXOXOOOXOOOXOXOOOOOXOOOXOXOXOOPPPXPPPXPXOXPPPPPPPXOXOOOXOX
XOXOXOXOXXXXXOXOXOXOXXXXXXXOXXXOXXXXXXXOXOXXXOXXXXXOXOXOXOXXXOXOXOXOXOXXXXXXXXXPXPXXXPXXXXXXXOXOXOXOX
XOXOXOOOXOOOOOXOXOOOXOOOOOXOXOOOXOOOOOOOXOOOXOXOOOOOXOOOXOOOXOXOXOXOOOXOOOXOOOXPXPPPXPPPXPPPXOOOXOXOX
XOXOXOXXXOXXXXXOXXXOXXXOXOXXXOXXXXXXXXXOXXXOXOXOXXXOXXXXXXXOXOXOXOXXXOXOXOXOXOXPXXXPXOXPXPXPXXXXXOXOX
XOXOXOXOXOOOOOXOXOXOOOOOXOOOXOXOOOOOOOXOOOXOXOXOXOXOOOXOOOXOXOXOXOOOXOOOXOXOXOOPPPPPXOXPPPXPXOOOXOOOX
XOXOXOXOXXXXXOXOXOXOXXXOXXXOXOXOXXXOXOXXXXXOXOXOXOXXXOXOXOXXXOXOXXXXXXXXXOXXXXXXXXXXXOXXXXXPXOXXXXXOX
XOXOXOOOOOOOXOXOOOXOOOXOXOXOXOOOXOOOXOXOOOOOXOXOOOXOOOXOXOOOXOXOOOXOOOOOOOXOOOXOOOOOXOOOOOXPXOOOOOXOX
XOXXXOXXXXXOXOXXXXXXXXXOXOXOXXXXXOXXXXXOXXXXXOXXXOXXXXXOXXXOXOXXXOXOXXXXXXXOXOXXXXXOXXXXXXXPXXXOXXXOX
XOXOOOOOXOXOXOXOOOOOOOXOXOOOXOOOOOXOOOOOXOOOXOOOXOXOOOOOXOOOXOXOOOXOXOOOXOOOXOOOXOOOXOOOXPPPXOOOOOXOX
XOXOXXXOXOXOXOXOXXXXXOXOXXXXXOXXXXXXXOXXXOXOXXXOXOXOXXXXXOXXXOXOXOXOXXXOXOXXXXXOXOXXXOXXXPXXXXXXXOXOX
XOOOXOXOXOOOXOXOOOXOOOXOXOOOOOXOOOOOOOXOOOXOXOOOXOXOOOXOOOXOXOOOXOXOOOOOXOOOOOXOOOXPPPPPPPOOOOXOOOXOX
XXXXXOXOXOXXXOXXXOXOXXXOXOXXXXXXXXXOXXXOXXXOXOXXXOXXXOXOXXXOXXXXXXXXXOXXXXXXXOXXXXXPXXXXXXXXXOXOXXXOX
XOOOXOOOXOXOOOXOOOXOOOXOOOXOOOXOOOXOXOOOXOXOOOXOOOOOOOXOOOXOOOOOXOOOXOOOOOXOOOXOXPPPXOOOOOXOOOXOOOOOX
XOXOXXXXXOXOXXXOXXXXXXXOXXXOXOXOXOXOXOXXXOXXXXXOXXXXXXXXXOXXXOXXXOXOXXXXXOXOXXXOXPXXXXXXXOXOXXXXXXXXX
XOXOXOXOOOXOXOOOXOOOOOOOXOOOXOXOXOOOXOXOOOOOOOOOXOXOOOOOXOXOOOOOOOXOOOXOXOXOXOOOXPOOOOOOXOXOXOOOOOOOX
XOXOXOXOXXXOXOXXXOXXXXXXXOXOXOXOXXXOXOXXXXXXXXXXXOXOXXXOXOXOXXXXXXXXXOXOXOXOXOXOXPXXXXXOXOXOXOXXXOXXX
XOXOOOXOOOXOXOOOXOOOXOOOOOXOXOXOXOXOOOXOOOOOOOOOOOXOOOXOOOXOOOXOXOOOOOOOXOOOXOXOXPPPXOOOXOXOXOOOXOOOX
XOXXXXXXXOXOXXXOXXXOXOXXXXXXXOXOXOXXXXXOXOXXXOXXXXXXXOXXXXXXXOXOXOXXXXXXXOXXXOXXXXXPXOXXXOXXXOXOXOXOX
XOXOOOOOXOXOXOOOXOOOXOXOOOOOOOXOOOOOOOOOXOXOXOXOOOOOXOOOOOOOOOXOOOXOXOOOXOOOXOOOOOXPXOOOOOOOXOXOXOXOX
XOXOXXXOXOXXXOXXXXXOXOXXXXXXXXXXXXXXXXXXXOXOXOXOXXXOXXXXXXXXXXXXXOXOXOXOXXXXXXXXXOXPXXXXXXXOXOXXXOXOX
XOOOOOXOOOOOXOXOOOXOOOOOOOOOOOOOXOOOOOOOXOOOXOXOXOXOXOOOOOXOOOOOOOXOXOXOOOOOOOXOOOXPXOOOOOXOXOXOOOXOX
XXXXXOXXXXXOXOXOXOXXXXXOXXXXXXXOXOXXXXXXXOXOXOXOXOXOXOXXXOXOXXXOXXXOXOXXXXXXXOXOXXXPXXXXXOXOXXXOXXXOX
XOOOOOXOOOOOXOXOXOOOOOXOXOOOOOOOXOOOXOOOOOXOXOXOOOXOOOXOXOXOXOOOXOOOOOXOOOOOXOXOXPPPXOOOXOOOXOOOXOOOX
XOXXXXXXXXXOXOXOXXXXXOXXXOXXXXXXXOXOXOXXXXXOXXXXXXXOXXXOXOXOXXXXXOXXXXXOXXXOXOXOXPXXXOXOXXXOXOXXXXXOX
XOOOXOXOOOOOXOOOOOOOXOOOOOOOXOOOXOXOXOXOOOXOXOOOOOOOXOOOXOXOOOXOOOXOOOOOXOOOXOOOXPPPXOXOOOXOXOOOOOXOX
XXXOXOXOXXXXXXXXXXXOXXXXXXXOXOXOXXXOXOXOXXXOXOXXXXXXXXXOXOXXXOXOXXXXXXXOXOXXXXXXXXXPXXXXXOXOXXXXXOXOX
XOOOXOOOOOOOOOOOOOXOOOXOOOOOXOXOOOXOXOXOOOOOXOOOOOXOOOOOXOOOOOOOXOOOOOXOXOOOOOOOOOXPPPPPXOOOXOOOOOXOX
XOXOXXXXXXXXXXXXXXXXXOXXXXXXXOXXXOXOXOXXXXXOXXXXXOXOXOXXXXXXXXXXXOXXXOXXXOXXXXXXXOXXXOXPXXXXXOXXXXXOX
XOXOOOOOOOXOOOOOOOOOOOXOOOOOXOXOOOOOXOXOOOXOXOXOOOXOXOOOOOOOXOOOOOXOXOOOXOXOOOOOOOOOXOXPPPPPXOOOXOXOX
XXXXXXXXXOXXXXXOXXXXXXXOXXXOXOXOXXXXXOXOXOXOXOXOXXXXXXXXXXXOXOXXXXXOXXXOXXXOXXXXXXXXXOXXXXXPXXXOXOXOX
XPPPPPPPXOXOOOXOOOOOOOOOXOOOXOXOXOOOOOXOXOXOXOXOOOOOOOOOOOXOOOXOOOOOOOXOXOOOOOOOXOOOXOOOXPPPXOOOXOOOX
XPXXXOXPXOXOXOXXXXXXXXXXXOXXXOXXXOXXXXXOXOXOXOXXXOXXXOXXXOXXXOXXXXXOXXXOXOXXXXXXXOXOXOXXXPXXXOXXXOXXX
XPPPXOXPXOOOXOOOOOOOOOXOOOXOOOXOOOXOOOXOXOOOOOOOOOXOOOXOOOXOOOXOOOOOXOOOXOOOOOOOOOXOOOXPPPXOOOOOXOOOX
XXXPXXXPXXXXXXXXXXXXXOXOXXXOXOXOXXXOXOXOXXXXXXXXXXXXXXXXXXXOXXXOXXXXXOXXXXXXXOXXXXXXXXXPXXXOXXXXXXXOX
XPPPXPPPXPPPPPPPPPPPXOXOOOXOXOOOXOOOXOXOXOOOOOXOXOOOXOOOOOXOOOXOXOOOOOXOOOXOOOXOOOXPPPXPPPXOXOOOOOOOX
XPXXXPXOXPXXXXXXXXXPXXXXXOXXXXXXXOXXXOXOXOXXXOXOXOXOXOXXXOXXXOXOXOXXXXXOXOXOXOXXXOXPXPXXXPXOXXXXXXXXX
XPXPPPXOXPPPXOOOOOXPXOOOXOOOXOOOXOOOXOOOXOOOXOOOOOXOXOXOOOXOXOOOXOXOOOOOXOOOXOOOOOXPXPPPXPXOXOOOOOOOX
XPXPXXXOXXXPXOXXXOXPXOXOXXXOXOXXXOXXXXXXXXXXXXXXXOXXXOXOXXXOXOXXXOXOXXXXXXXXXXXXXXXPXXXPXPXOXOXXXOXOX
XPXPPPXOOOXPXOXOXPPPXOXOOOOOXOOOOOXOOOOOXOOOOOXOOOOOOOXOOOXOOOXOOOXOXPPPPPPPPPXPPPPPXOXPPPXOOOXOOOXOX
XPXXXPXXXXXPXOXOXPXXXOXXXXXXXOXXXXXOXXXOXOXOXOXXXXXXXXXXXOXXXOXOXXXXXPXXXXXXXPXPXXXXXOXOXXXXXXXOXXXOX
XPPPXPPPPPPPXOOOXPPPPPPPXOOOOOXOOOXOOOXOXOXOXOXOOOXOOOXOOOOOXOXOOOOOOPXOOOOOXPPPXOOOXOXOOOOOOOXOOOXOX
XXXPXXXXXXXXXXXXXXXXXXXPXOXOXXXOXOXXXOXOXOXOXOXOXOXOXOXXXXXOXXXXXXXOXPXXXXXOXXXXXOXOXOXXXXXXXOXXXXXOX
XPPPXOOPPPXOOPPPXOOOOOXPXOXOXOXOXOXOOOXOOOXOXOXOXOOOXOXOOOXOOOXOXOOOXPPPXOXOOOOOXOXOXOOOXOOOXOOOOOXOX
XPXXXOXPXPXXXPXPXXXXXOXPXXXOXOXOXOXOXXXXXXXOXOXOXXXXXOXOXXXXXOXOXOXXXXXPXOXOXXXXXOXOXXXOXXXOXXXOXOXOX
XPXOOOXPXPPPPPXPOOXOXOXPPPXOOOOOXOOOXOOOOOOOXOOOXOOOOOXOOOOOXOXOOOOOXPPPOOOOXOOOOOXOOOOOXOOOOOXOXOOOX
XPXOXXXPXXXXXXXPXOXOXOXXXPXXXXXXXXXXXOXXXXXXXXXXXOXXXXXOXXXOXOXXXOXXXPXXXXXXXOXXXXXXXXXXXOXXXOXOXXXXX
XPXOXPPPXOOOOOXPXOOOXOXPPPXOOOXOOOOOOOOOOOXOOOOOXOOOOOXOXOOOXOOOXOXPPPXOOOXOOOXOOOOOOOOOOOXOOOXOOOOOX
XPXXXPXXXOXXXOXPXXXOXOXPXXXOXOXOXXXXXXXXXOXXXOXXXXXXXOXXXOXOXXXOXXXPXXXXXOXOXXXOXXXXXXXXXXXXXXXXXXXOX
XPPPXPPPXOOOXOXPOOXOOOXPPPXOXOOOOOOOXOOOXOOOXOOOOOOOXOOOXOXOOOXOXPPPXOOOOOXOOOXOOOOOOOXOOOOOOOXOOOXOX
XOXPXXXPXXXOXXXPXXXXXXXXXPXXXXXXXXXXXOXXXXXOXXXXXOXXXOXOXOXXXXXOXPXOXOXXXXXXXOXXXXXXXOXOXOXXXOXOXOXOX
XOXPPPPPXPPPPPXPPPPPXOOPPPXOOOXOOOOOOOOOOOXOXOOOOOXOOOXOXOOOXOOOXPXOXOXOOOXOXOXOOOXOOOXOXOOOXOOOXOOOX
XXXXXXXXXPXXXPXXXXXPXOXPXOXOXOXXXOXXXXXXXOXOXOXXXXXOXXXXXOXOXOXXXPXOXOXOXOXOXOXOXOXOXOXOXXXOXXXXXXXXX
XPPPPPPPPPOOXPXPPPXPXOXPXOXOXOOOOOXOOOXOXOOOXOXOOOOOXOOOOOXOXPPPPPXOXOXOXOXOOOXOXOXOXOXOXOOOXOOOOOOOX
XPXXXXXXXXXXXPXPXPXPXXXPXXXOXXXXXXXXXOXOXXXXXOXXXXXOXOXOXXXXXPXXXXXXXOXOXOXOXXXOXOXOXXXOXOXXXXXOXOXXX
XPXOOOOOOOXOOPPPXPXPPPXPXOOOXOOOOOOOOOXOOOOOOOXPPPXOOOXOXPPPXPXOOOOOOOXOXOXOOOXOXOXOXOOOXOXOOOXOXOOOX
XPXOXXXXXOXOXXXXXPXXXPXPXOXXXOXXXOXXXXXOXXXXXXXPXPXXXXXXXPXPXPXXXXXOXXXXXOXXXOXXXOXOXOXXXOXXXOXXXXXOX
XPXOOOXOXOXOXOOOXPPPPPXPXOXOOOOOXOOOOOOOXOOPPPPPXPPPPPXPPPXPXPXOOOOOXOOOOOOOOOXOOOOOXOOOXOOOOOOOXOOOX
XPXXXOXOXOXOXXXOXXXXXXXPXOXOXXXOXXXXXXXXXOXPXXXXXXXXXPXPXXXPXPXOXOXXXOXXXXXXXXXOXXXOXXXOXXXXXXXOXOXXX
XPPPXOOOXOXOOOOOXOOOOOXPXOOOXOOOXPPPPPPPXOXPXPPPXPPPXPXPXOXPPPXOXOXOOOXOOOOOOOXOOOXOXOXOOOOOXOOOXOOOX
XXXPXXXOXXXOXXXOXXXXXOXPXXXXXXXXXPXXXXXPXOXPXPXPXPXPXPXPXOXXXXXOXOXXXOXOXXXXXOXXXXXOXOXXXXXOXOXOXXXOX
XOXPXOXOOOXOOOXOXOOOXOXPPPPPPPPPPPXPPPXPXOXPXPXPPPXPXPXPPPPPOOOOXOOOOOXOOOOOXOXOOOXOXOOOOOOOXOXOOOXOX
XOXPXOXXXOXXXOXOXOXOXOXXXXXXXXXXXXXPXPXPXOXPXPXXXXXPXPXXXXXPXXXXXXXXXXXXXXXOXOXOXOXOXOXXXXXXXOXXXOXOX
XOXPPPXOOOXOXOXOOOXOOOOOOOOOOOXOXPPPXPPPXOXPXPPPXPPPXPPPXOXPPPPPPPXOXOOOXOOOXOOOXOXOOOXOOOOOXOOOXOOOX
XOXOXPXOXXXOXOXXXXXXXXXXXXXXXOXOXPXXXXXOXXXPXXXPXPXXXXXPXOXXXXXXXPXOXOXOXXXOXXXOXOXXXXXXXOXXXXXOXXXXX
XOOOXPXOOOXOOOXOOOOOXOOOXOOOXOOOXPPPPPXOXPPPXOXPXPPPPPXPXOXPPPXOOPXOXOXOOOXOOOXOXOXOXOOOXOXOOOXOXOOOX
XXXXXPXXXOXXXXXOXXXOXOXXXOXOXOXOXXXXXPXXXPXXXOXPXXXXXPXPXOXPXPXXXPXOXOXXXOXXXOXOXOXOXOXOXOXOXOXOXXXOX
XOOOXPPPXOOOXOOOOOXOXOOOXOXOOOXOXOOOXPPPXPXOOOXPPPPPXPPPXPPPXPPPPPXOOOOOXOOOOOXOXOXOOOXOXOXOXOOOXOOOX
XOXOXXXPXXXOXOXXXOXOXXXOXOXXXXXOXOXOXXXPXPXOXOXXXXXPXXXXXPXXXXXXXXXXXXXOXXXXXXXOXOXOXXXOXOXOXXXXXOXOX
XOXOOOXPXOXOOOXOOOXOOOXOXOOOOOXOXOXOXPPPXPXOXOOOXPPPXPPPPPXOOOOOOOOOOOXOOOXOOOXOXOXOOOXOOOOOXOOOOOXOX
XOXXXOXPXOXXXXXOXXXOXOXOXOXXXXXOXOXXXPXXXPXOXXXOXPXXXPXXXXXXXXXXXXXXXOXXXOXOXOXXXOXOXXXXXXXXXXXXXOXOX
XOOOXOXPXOXPPPXOOOXOXOOOXOXOOOOOXOOOXPXPPPXOXOOOXPXPPPXOOOOOOOXOOOOOOOXOOOXOXOXOOOXOXOOOOOXOOOOOXOXOX
XXXOXOXPXOXPXPXXXOXXXXXOXXXOXXXXXXXOXPXPXXXOXXXXXPXPXXXOXOXXXOXOXXXXXOXXXXXOXOXOXXXOXOXXXOXXXOXOXOXXX
XOOOXOXPPPXPXPXOOOXOOOXOOOOOXOOOXOOOXPPPXOOOXPPPPPXPPPXOXOXOOOXOOOXOXOOOOOOOXOOOXOXOOOXOXOOOOOXOXOOOX
XOXOXOXXXPXPXPXOXXXOXXXXXXXXXXXOXOXXXXXOXOXOXPXXXXXXXPXOXOXOXXXXXOXOXXXOXXXXXXXXXOXXXXXOXXXXXXXOXXXOX
XOXOXOXOXPPPXPXOOOXOOOOOOOOOOOOOXOOOXOOOXOXOXPXPPPXPPPXOXOXOOOOOOOXOOOXOXOOOXOOOOOOOXOOOOOOOOOXOOOXOX
XOXOXOXOXXXXXPXXXOXXXXXOXXXOXXXXXXXOXOXXXXXOXPXPXPXPXXXOXOXXXXXOXXXOXOXOXOXXXOXXXOXOXXXXXOXXXXXOXOXOX
XOXOXOXPPPPPXPXOOOXOOOXOOOXOOOOOOOOOXOOOOOXOXPXPXPXPOOXOXOOOOOXOXOOOXOXOXOOOOOXOXOXOOOOOOOXOOOXOXOXOX
XOXOXXXPXOXPXPXOXXXOXOXXXXXXXOXXXOXXXOXXXOXOXPXPXPXPXOXXXXXXXXXOXOXXXXXOXXXOXXXOXOXXXXXXXXXOXOXOXOXOX
XOXOOOOPXOXPPPXOOOOOXOOOOOOOOOXOOOXOOOOOXOOOXPPPXPPPXOOOOOOOOOOOXOOOOOOOOOXOOOOOXOOOOOOOOOOOXOOOXOOOX
XXXXXXXSXXXXXXXXXXXXXXXXXXXXXXXXXXXXXXXXXXXXXXXXXXXXXXXXXXXXXXXXXXXXXXXXXXXXXXXXXXXXXXXXXXXXXXXXXXXXX