3
5 5 2
XOXXX
XOXXX
XOXXX
XOOOO
XXXXX

XEXXX
XXXXX
XXXXX
OOOOO
SXXXX